###################
###.............###
##...............##
#........@........#
#.................#
#.................#
#.................#
#.................#
#.................#
##...............##
###.............###
###################