###################
#.................#
#.................#
#.................#
#.................#
#....@............#
#.................#
#.................#
#.................#
#.................#
#.................#
###################