###################
#.................#
#.###.........###.#
#.###.........###.#
#.....#######.....#
#........@........#
#.....#######.....#
#.................#
#.###.........###.#
#.###.........###.#
#.................#
###################